#grafika kafelek
kafelki.jpg

#rozmiar mapy w kafelkach[x, y]
25 25

#rozmiar kafelka[x, y]
48 48

#mapa
 37 28 46 28 46 10 10 28 37 28 28 10 37 37 10 37 37 28 10 28 37 46 10 28 37
 28 10 37 28 46 46 46 28 10 37 37 37 37 10 46 10 37 46 37 10 28 28 10 10 10
 37 28 37 28 37 46 46 10 28 28 37 28 46 37 10 37 28 10 28 46 28 10 46 10 37
 10 10 46 37 37 37 37 10 46 37 46 46 10 37 46 10 46 10 10 28 28 37 46 46 46
 10 10 37 46 37 37 37 10 46 37 10 28 37 10 28 28 37 28 37 46 28 46 28 10 28
 28 37 28 46 37 28 46 46 28 10 10 10 37 10 10 46 46 28 10 37 46 37 28 46 46
 28 10 37 10 37 28 46 10 37 28 46 10 46 28 37 37 37 10 37 37 10 10 37 37 28
 46 10 37 37 46 46 28 28 10 10 37 37 28 10 28 10 37 37 37 10 10 37 37 28 28
 28 46 28 37 37 46 46 46 37 10 37 37 46 37 28 37 37 10 46 10 37 10 10 37 28
 37 28 10 28 37 28 28 28 28 10 10 28 28 10 37 46 10 37 37 10 10 37 37 37 46
 37 46 46 10 10 10 37 10 28 37 10 46 28 10 37 10 28 28 37 37 10 46 46 46 28
 46 10 28 46 10 46 46 37 28 37 46 28 28 37 37 28 28 10 46 28 28 28 46 46 37
 10 10 37 46 28 28 46 37 28 28 28 28 28 10 10 37 37 46 37 46 37 37 10 28 46
 37 37 10 10 10 37 37 28 10 37 10 46 37 28 37 28 37 46 10 10 37 46 46 28 10
 10 28 10 28 46 46 46 37 10 28 10 28 46 28 10 37 28 28 10 28 46 46 37 46 37
 37 10 28 10 37 37 10 37 46 28 46 37 37 46 28 37 28 37 46 37 10 28 28 46 46
 10 10 10 28 46 46 37 37 28 10 37 37 28 37 37 37 37 10 10 37 46 28 28 46 10
 28 37 28 10 46 46 28 46 28 28 28 46 46 37 10 46 10 37 10 37 28 10 28 37 10
 37 10 37 10 28 46 10 28 10 46 28 37 37 46 37 28 37 46 10 46 46 10 37 28 10
 37 28 37 28 10 10 37 46 46 37 37 28 28 28 28 46 46 10 46 46 28 46 10 37 28
 28 46 10 46 37 46 46 46 46 28 28 46 37 46 10 46 37 28 28 37 46 46 10 46 28
 37 46 10 46 37 28 28 37 37 37 10 46 37 10 46 37 37 46 46 46 46 10 10 37 10
 37 37 28 28 46 37 28 37 37 46 37 37 10 37 46 37 10 10 37 28 37 46 46 10 10
 10 46 37 10 46 37 37 10 46 28 46 46 10 37 28 46 37 28 28 46 10 10 28 46 28
 28 28 37 37 46 28 46 10 37 10 46 46 37 10 37 46 37 46 10 37 28 28 37 37 37
